chromosome,end_bp,id1,id1_haplotype,id2,id2_haplotype,start_bp,length
1,205727467,0,0,2,0,62229854,143497613
1,62229854,0,1,2,0,752721,61477133
1,249222527,0,1,2,0,205727467,43495060
1,47892626,0,0,3,0,20832334,27060292
1,115887745,0,0,3,0,98354800,17532945
1,20832334,0,1,3,0,752721,20079613
1,98354800,0,1,3,0,47892626,50462174
1,249222527,0,1,3,0,115887745,133334782
1,191871968,0,0,6,1,62229854,129642114
1,62229854,0,1,6,1,44597215,17632639
1,115887745,0,0,7,0,107624523,8263222
1,177487659,0,1,7,0,115887745,61599914
1,249222527,0,1,7,0,192185083,57037444
1,88931244,0,0,10,1,62229854,26701390
1,62229854,0,1,10,1,44597215,17632639
1,110686540,0,0,11,0,107624523,3062017
1,177487659,0,1,11,0,148870975,28616684
1,213490218,0,1,11,0,192185083,21305135
1,249222527,1,0,2,1,752721,248469806
1,170129797,1,0,3,1,752721,169377076
1,249222527,1,1,3,1,170129797,79092730
1,44597215,1,0,6,1,752721,43844494
1,249222527,1,0,6,1,191871968,57350559
1,107624523,1,0,7,0,752721,106871802
1,192185083,1,1,7,0,177487659,14697424
1,17587381,1,0,10,1,752721,16834660
1,44597215,1,0,10,1,31568831,13028384
1,107624523,1,0,11,0,42469565,65154958
1,192185083,1,1,11,0,177487659,14697424
1,20832334,2,0,3,0,752721,20079613
1,62229854,2,0,3,0,47892626,14337228
1,115887745,2,0,3,0,98354800,17532945
1,249222527,2,0,3,0,205727467,43495060
1,170129797,2,1,3,1,752721,169377076
1,62229854,2,0,6,1,44597215,17632639
1,191871968,2,0,6,1,62229854,129642114
1,44597215,2,1,6,1,752721,43844494
1,249222527,2,1,6,1,191871968,57350559
1,115887745,2,0,7,0,107624523,8263222
1,249222527,2,0,7,0,205727467,43495060
1,107624523,2,1,7,0,752721,106871802
1,62229854,2,0,10,1,44597215,17632639
1,88931244,2,0,10,1,62229854,26701390
1,17587381,2,1,10,1,752721,16834660
1,44597215,2,1,10,1,31568831,13028384
1,110686540,2,0,11,0,107624523,3062017
1,213490218,2,0,11,0,205727467,7762751
1,107624523,2,1,11,0,42469565,65154958
1,62229854,3,0,6,1,47892626,14337228
1,115887745,3,0,6,1,98354800,17532945
1,44597215,3,1,6,1,752721,43844494
1,115887745,3,0,7,0,107624523,8263222
1,177487659,3,0,7,0,115887745,61599914
1,249222527,3,0,7,0,192185083,57037444
1,107624523,3,1,7,0,752721,106871802
1,192185083,3,1,7,0,177487659,14697424
1,62229854,3,0,10,1,47892626,14337228
1,17587381,3,1,10,1,752721,16834660
1,44597215,3,1,10,1,31568831,13028384
1,110686540,3,0,11,0,107624523,3062017
1,177487659,3,0,11,0,148870975,28616684
1,213490218,3,0,11,0,192185083,21305135
1,107624523,3,1,11,0,42469565,65154958
1,192185083,3,1,11,0,177487659,14697424
1,80430835,4,0,6,0,31129425,49301410
1,249222527,4,0,6,0,199539132,49683395
1,31129425,4,1,6,0,752721,30376704
1,199539132,4,1,6,0,80430835,119108297
1,31568831,4,0,10,1,31129425,439406
1,249222527,4,0,10,1,199539132,49683395
1,31129425,4,1,10,1,17587381,13542044
1,199539132,4,1,10,1,88931244,110607888
1,77737749,5,0,7,1,38582812,39154937
1,38582812,5,1,7,1,752721,37830091
1,249222527,5,1,7,1,77737749,171484778
1,42469565,5,0,11,0,38582812,3886753
1,38582812,5,1,11,0,752721,37830091
1,148870975,5,1,11,0,110686540,38184435
1,249222527,5,1,11,0,213490218,35732309
1,44597215,6,1,7,0,752721,43844494
1,115887745,6,1,7,0,107624523,8263222
1,31129425,6,0,10,1,17587381,13542044
1,31568831,6,0,10,1,31129425,439406
1,199539132,6,0,10,1,88931244,110607888
1,249222527,6,0,10,1,199539132,49683395
1,17587381,6,1,10,1,752721,16834660
1,44597215,6,1,10,1,31568831,13028384
1,62229854,6,1,10,1,44597215,17632639
1,88931244,6,1,10,1,62229854,26701390
1,44597215,6,1,11,0,42469565,2127650
1,110686540,6,1,11,0,107624523,3062017
1,17587381,7,0,10,1,752721,16834660
1,44597215,7,0,10,1,31568831,13028384
1,107624523,7,0,11,0,42469565,65154958
1,110686540,7,0,11,0,107624523,3062017
1,177487659,7,0,11,0,148870975,28616684
1,192185083,7,0,11,0,177487659,14697424
1,213490218,7,0,11,0,192185083,21305135
1,38582812,7,1,11,0,752721,37830091
1,42469565,7,1,11,0,38582812,3886753
1,148870975,7,1,11,0,110686540,38184435
1,249222527,7,1,11,0,213490218,35732309
1,102596513,8,0,10,0,17961032,84635481
1,120229022,8,0,10,0,110361848,9867174
1,17961032,8,1,10,0,752721,17208311
1,110361848,8,1,10,0,102596513,7765335
1,249222527,8,1,10,0,120229022,128993505
1,107460661,9,0,11,1,752721,106707940
1,249222527,9,0,11,1,122281403,126941124
1,122281403,9,1,11,1,107460661,14820742
1,44597215,10,1,11,0,42469565,2127650
2,171830785,0,0,2,0,99053519,72777266
2,99053519,0,1,2,0,11944,99041575
2,243041411,0,1,2,0,171830785,71210626
2,177698935,0,0,3,0,133856179,43842756
2,243041411,0,0,3,0,179725727,63315684
2,133856179,0,1,3,0,11944,133844235
2,179725727,0,1,3,0,177698935,2026792
2,110271110,0,0,6,1,99053519,11217591
2,25260867,0,1,6,1,11944,25248923
2,99053519,0,1,6,1,71837388,27216131
2,243041411,0,1,6,1,210842272,32199139
2,155321028,0,0,7,0,133856179,21464849
2,133856179,0,1,7,0,11944,133844235
2,243041411,1,0,2,1,45213068,197828343
2,45213068,1,1,2,1,11944,45201124
2,17678228,1,0,3,1,11944,17666284
2,144433588,1,0,3,1,78316416,66117172
2,224228180,1,0,3,1,160704624,63523556
2,78316416,1,1,3,1,17678228,60638188
2,160704624,1,1,3,1,144433588,16271036
2,243041411,1,1,3,1,224228180,18813231
2,71837388,1,0,6,1,45213068,26624320
2,210842272,1,0,6,1,110271110,100571162
2,45213068,1,1,6,1,25260867,19952201
2,224228180,1,0,7,0,160704624,63523556
2,160704624,1,1,7,0,155321028,5383596
2,243041411,1,1,7,0,224228180,18813231
2,243041411,1,1,11,0,234816439,8224972
2,99053519,2,0,3,0,11944,99041575
2,171830785,2,0,3,0,133856179,37974606
2,179725727,2,0,3,0,177698935,2026792
2,45213068,2,1,3,1,17678228,27534840
2,144433588,2,1,3,1,78316416,66117172
2,224228180,2,1,3,1,160704624,63523556
2,25260867,2,0,6,1,11944,25248923
2,99053519,2,0,6,1,71837388,27216131
2,110271110,2,0,6,1,99053519,11217591
2,243041411,2,0,6,1,210842272,32199139
2,45213068,2,1,6,1,25260867,19952201
2,71837388,2,1,6,1,45213068,26624320
2,210842272,2,1,6,1,110271110,100571162
2,99053519,2,0,7,0,11944,99041575
2,155321028,2,0,7,0,133856179,21464849
2,224228180,2,1,7,0,160704624,63523556
2,25260867,3,0,6,1,11944,25248923
2,99053519,3,0,6,1,71837388,27216131
2,45213068,3,1,6,1,25260867,19952201
2,144433588,3,1,6,1,110271110,34162478
2,210842272,3,1,6,1,160704624,50137648
2,133856179,3,0,7,0,11944,133844235
2,155321028,3,0,7,0,133856179,21464849
2,160704624,3,1,7,0,155321028,5383596
2,224228180,3,1,7,0,160704624,63523556
2,243041411,3,1,7,0,224228180,18813231
2,243041411,3,1,11,0,234816439,8224972
2,20003135,4,0,6,0,11944,19991191
2,136318848,4,0,6,0,98119577,38199271
2,239941543,4,0,6,0,177629861,62311682
2,98119577,4,1,6,0,20003135,78116442
2,177629861,4,1,6,0,136318848,41311013
2,243041411,4,1,6,0,239941543,3099868
2,20003135,4,0,10,1,11944,19991191
2,136318848,4,0,10,1,98119577,38199271
2,239941543,4,0,10,1,177629861,62311682
2,98119577,4,1,10,1,20003135,78116442
2,177629861,4,1,10,1,136318848,41311013
2,243041411,4,1,10,1,239941543,3099868
2,125787078,5,0,7,1,120417269,5369809
2,243041411,5,0,7,1,212509435,30531976
2,120417269,5,1,7,1,11944,120405325
2,212509435,5,1,7,1,125787078,86722357
2,125787078,5,0,11,0,120417269,5369809
2,234816439,5,0,11,0,212509435,22307004
2,120417269,5,1,11,0,11944,120405325
2,212509435,5,1,11,0,125787078,86722357
2,25260867,6,1,7,0,11944,25248923
2,99053519,6,1,7,0,71837388,27216131
2,210842272,6,1,7,0,160704624,50137648
2,20003135,6,0,10,1,11944,19991191
2,98119577,6,0,10,1,20003135,78116442
2,136318848,6,0,10,1,98119577,38199271
2,177629861,6,0,10,1,136318848,41311013
2,239941543,6,0,10,1,177629861,62311682
2,243041411,6,0,10,1,239941543,3099868
2,243041411,7,0,11,0,234816439,8224972
2,120417269,7,1,11,0,11944,120405325
2,125787078,7,1,11,0,120417269,5369809
2,212509435,7,1,11,0,125787078,86722357
2,234816439,7,1,11,0,212509435,22307004
2,243041411,8,0,10,0,11944,243029467
2,130141150,9,0,11,1,75373190,54767960
2,231677537,9,0,11,1,142225885,89451652
2,75373190,9,1,11,1,11944,75361246
2,142225885,9,1,11,1,130141150,12084735
2,243041411,9,1,11,1,231677537,11363874
3,197385301,0,0,2,0,66206,197319095
3,197840413,0,1,2,0,197385301,455112
3,41956564,0,0,3,0,66206,41890358
3,178267026,0,0,3,0,146011456,32255570
3,146011456,0,1,3,0,41956564,104054892
3,197840413,0,1,3,0,178267026,19573387
3,75734802,0,0,6,1,61847076,13887726
3,197385301,0,0,6,1,118561893,78823408
3,197840413,0,1,6,1,197385301,455112
3,24973757,0,0,7,0,66206,24907551
3,178267026,0,0,7,0,146011456,32255570
3,146011456,0,1,7,0,117415411,28596045
3,197840413,0,1,7,0,178267026,19573387
3,75734802,0,0,10,1,61847076,13887726
3,175585031,0,0,10,1,118561893,57023138
3,24973757,0,0,11,0,12355204,12618553
3,174089987,0,0,11,0,151991842,22098145
3,132813020,0,1,11,0,117415411,15397609
3,98087588,1,0,2,1,66206,98021382
3,197840413,1,1,2,1,98087588,99752825
3,23827560,1,0,3,1,4056029,19771531
3,167006690,1,0,3,1,112174817,54831873
3,4056029,1,1,3,1,66206,3989823
3,112174817,1,1,3,1,23827560,88347257
3,197840413,1,1,3,1,167006690,30833723
3,61847076,1,0,6,1,66206,61780870
3,98087588,1,0,6,1,75734802,22352786
3,118561893,1,1,6,1,98087588,20474305
3,117415411,1,0,7,0,112174817,5240594
3,112174817,1,1,7,0,24973757,87201060
3,61847076,1,0,10,1,66206,61780870
3,98087588,1,0,10,1,75734802,22352786
3,118561893,1,1,10,1,98087588,20474305
3,117415411,1,0,11,0,112174817,5240594
3,112174817,1,1,11,0,24973757,87201060
3,41956564,2,0,3,0,66206,41890358
3,178267026,2,0,3,0,146011456,32255570
3,197840413,2,0,3,0,197385301,455112
3,23827560,2,1,3,1,4056029,19771531
3,112174817,2,1,3,1,98087588,14087229
3,197840413,2,1,3,1,167006690,30833723
3,75734802,2,0,6,1,61847076,13887726
3,197385301,2,0,6,1,118561893,78823408
3,197840413,2,0,6,1,197385301,455112
3,61847076,2,1,6,1,66206,61780870
3,98087588,2,1,6,1,75734802,22352786
3,118561893,2,1,6,1,98087588,20474305
3,24973757,2,0,7,0,66206,24907551
3,178267026,2,0,7,0,146011456,32255570
3,197840413,2,0,7,0,197385301,455112
3,112174817,2,1,7,0,98087588,14087229
3,75734802,2,0,10,1,61847076,13887726
3,175585031,2,0,10,1,118561893,57023138
3,61847076,2,1,10,1,66206,61780870
3,98087588,2,1,10,1,75734802,22352786
3,118561893,2,1,10,1,98087588,20474305
3,24973757,2,0,11,0,12355204,12618553
3,174089987,2,0,11,0,151991842,22098145
3,112174817,2,1,11,0,98087588,14087229
3,178267026,3,0,6,1,146011456,32255570
3,197840413,3,0,6,1,197385301,455112
3,23827560,3,1,6,1,4056029,19771531
3,112174817,3,1,6,1,98087588,14087229
3,24973757,3,0,7,0,66206,24907551
3,146011456,3,0,7,0,117415411,28596045
3,178267026,3,0,7,0,146011456,32255570
3,197840413,3,0,7,0,178267026,19573387
3,112174817,3,1,7,0,24973757,87201060
3,117415411,3,1,7,0,112174817,5240594
3,175585031,3,0,10,1,146011456,29573575
3,23827560,3,1,10,1,4056029,19771531
3,112174817,3,1,10,1,98087588,14087229
3,24973757,3,0,11,0,12355204,12618553
3,132813020,3,0,11,0,117415411,15397609
3,174089987,3,0,11,0,151991842,22098145
3,112174817,3,1,11,0,24973757,87201060
3,117415411,3,1,11,0,112174817,5240594
3,37999716,4,0,6,0,66206,37933510
3,197840413,4,0,6,0,60383689,137456724
3,60383689,4,1,6,0,37999716,22383973
3,197840413,4,0,10,1,175585031,22255382
3,100599138,5,0,7,1,66206,100532932
3,197840413,5,1,7,1,100599138,97241275
3,12355204,5,0,11,0,66206,12288998
3,151991842,5,1,11,0,132813020,19178822
3,197840413,5,1,11,0,174089987,23750426
3,112174817,6,1,7,0,98087588,14087229
3,178267026,6,1,7,0,146011456,32255570
3,197840413,6,1,7,0,197385301,455112
3,197840413,6,0,10,1,175585031,22255382
3,61847076,6,1,10,1,66206,61780870
3,75734802,6,1,10,1,61847076,13887726
3,98087588,6,1,10,1,75734802,22352786
3,118561893,6,1,10,1,98087588,20474305
3,175585031,6,1,10,1,118561893,57023138
3,112174817,6,1,11,0,98087588,14087229
3,174089987,6,1,11,0,151991842,22098145
3,112174817,7,0,10,1,98087588,14087229
3,175585031,7,0,10,1,146011456,29573575
3,24973757,7,0,11,0,12355204,12618553
3,112174817,7,0,11,0,24973757,87201060
3,117415411,7,0,11,0,112174817,5240594
3,132813020,7,0,11,0,117415411,15397609
3,174089987,7,0,11,0,151991842,22098145
3,12355204,7,1,11,0,66206,12288998
3,151991842,7,1,11,0,132813020,19178822
3,197840413,7,1,11,0,174089987,23750426
3,23505404,8,0,10,0,66206,23439198
3,197840413,8,1,10,0,23505404,174335009
3,119687967,9,0,11,1,99693396,19994571
3,197840413,9,0,11,1,185753204,12087209
3,99693396,9,1,11,1,66206,99627190
3,185753204,9,1,11,1,119687967,66065237
3,112174817,10,1,11,0,98087588,14087229
3,174089987,10,1,11,0,151991842,22098145
4,7949034,0,0,2,0,73071,7875963
4,120310616,0,0,2,0,21485516,98825100
4,155404177,0,0,2,0,144496556,10907621
4,21485516,0,1,2,0,7949034,13536482
4,144496556,0,1,2,0,120310616,24185940
4,190915650,0,1,2,0,155404177,35511473
4,13388025,0,0,3,0,73071,13314954
4,190915650,0,1,3,0,13388025,177527625
4,114874344,0,0,6,1,35735961,79138383
4,13388025,0,0,7,0,2698088,10689937
4,31370535,0,1,7,0,13388025,17982510
4,96281283,0,1,7,0,48547471,47733812
4,181445228,0,1,7,0,121471360,59973868
4,13388025,0,0,11,0,2698088,10689937
4,31370535,0,1,11,0,13388025,17982510
4,60786580,0,1,11,0,48547471,12239109
4,96281283,0,1,11,0,88921540,7359743
4,104608692,1,0,2,1,16400084,88208608
4,162938660,1,0,2,1,156492339,6446321
4,16400084,1,1,2,1,73071,16327013
4,156492339,1,1,2,1,104608692,51883647
4,190915650,1,1,2,1,162938660,27976990
4,144813513,1,0,3,1,73071,144740442
4,190915650,1,1,3,1,144813513,46102137
4,35735961,1,0,6,1,16400084,19335877
4,162938660,1,0,6,1,156492339,6446321
4,16400084,1,1,6,1,73071,16327013
4,156492339,1,1,6,1,114874344,41617995
4,190915650,1,1,6,1,162938660,27976990
4,2698088,1,0,7,0,73071,2625017
4,48547471,1,0,7,0,31370535,17176936
4,121471360,1,0,7,0,96281283,25190077
4,190915650,1,1,7,0,181445228,9470422
4,2698088,1,0,11,0,73071,2625017
4,48547471,1,0,11,0,31370535,17176936
4,117103805,1,0,11,0,96281283,20822522
4,7949034,2,0,3,0,73071,7875963
4,21485516,2,0,3,0,13388025,8097491
4,144496556,2,0,3,0,120310616,24185940
4,190915650,2,0,3,0,155404177,35511473
4,104608692,2,1,3,1,16400084,88208608
4,156492339,2,1,3,1,144813513,11678826
4,190915650,2,1,3,1,162938660,27976990
4,114874344,2,0,6,1,35735961,79138383
4,16400084,2,1,6,1,73071,16327013
4,35735961,2,1,6,1,16400084,19335877
4,156492339,2,1,6,1,114874344,41617995
4,162938660,2,1,6,1,156492339,6446321
4,190915650,2,1,6,1,162938660,27976990
4,7949034,2,0,7,0,2698088,5250946
4,21485516,2,0,7,0,13388025,8097491
4,144496556,2,0,7,0,121471360,23025196
4,181445228,2,0,7,0,155404177,26041051
4,48547471,2,1,7,0,31370535,17176936
4,104608692,2,1,7,0,96281283,8327409
4,190915650,2,1,7,0,181445228,9470422
4,7949034,2,0,11,0,2698088,5250946
4,21485516,2,0,11,0,13388025,8097491
4,48547471,2,1,11,0,31370535,17176936
4,104608692,2,1,11,0,96281283,8327409
4,35735961,3,1,6,1,16400084,19335877
4,156492339,3,1,6,1,144813513,11678826
4,190915650,3,1,6,1,162938660,27976990
4,13388025,3,0,7,0,2698088,10689937
4,31370535,3,0,7,0,13388025,17982510
4,96281283,3,0,7,0,48547471,47733812
4,181445228,3,0,7,0,121471360,59973868
4,2698088,3,1,7,0,73071,2625017
4,48547471,3,1,7,0,31370535,17176936
4,121471360,3,1,7,0,96281283,25190077
4,190915650,3,1,7,0,181445228,9470422
4,13388025,3,0,11,0,2698088,10689937
4,31370535,3,0,11,0,13388025,17982510
4,60786580,3,0,11,0,48547471,12239109
4,96281283,3,0,11,0,88921540,7359743
4,2698088,3,1,11,0,73071,2625017
4,48547471,3,1,11,0,31370535,17176936
4,117103805,3,1,11,0,96281283,20822522
4,93708141,4,0,6,0,28331313,65376828
4,190915650,4,0,6,0,117448993,73466657
4,28331313,4,1,6,0,73071,28258242
4,117448993,4,1,6,0,93708141,23740852
4,93708141,4,0,10,1,28331313,65376828
4,190915650,4,0,10,1,117448993,73466657
4,28331313,4,1,10,1,73071,28258242
4,117448993,4,1,10,1,93708141,23740852
4,143518328,5,0,7,1,73071,143445257
4,190915650,5,1,7,1,143518328,47397322
4,88921540,5,0,11,0,60786580,28134960
4,143518328,5,0,11,0,117103805,26414523
4,190915650,5,1,11,0,143518328,47397322
4,35735961,6,1,7,0,31370535,4365426
4,190915650,6,1,7,0,181445228,9470422
4,28331313,6,0,10,1,73071,28258242
4,93708141,6,0,10,1,28331313,65376828
4,117448993,6,0,10,1,93708141,23740852
4,190915650,6,0,10,1,117448993,73466657
4,35735961,6,1,11,0,31370535,4365426
4,2698088,7,0,11,0,73071,2625017
4,13388025,7,0,11,0,2698088,10689937
4,31370535,7,0,11,0,13388025,17982510
4,48547471,7,0,11,0,31370535,17176936
4,60786580,7,0,11,0,48547471,12239109
4,96281283,7,0,11,0,88921540,7359743
4,117103805,7,0,11,0,96281283,20822522
4,88921540,7,1,11,0,60786580,28134960
4,143518328,7,1,11,0,117103805,26414523
4,190915650,7,1,11,0,143518328,47397322
4,55355810,8,0,10,0,73071,55282739
4,190915650,8,1,10,0,55355810,135559840
4,57575276,9,0,11,1,10846839,46728437
4,190915650,9,0,11,1,68630693,122284957
4,10846839,9,1,11,1,73071,10773768
4,68630693,9,1,11,1,57575276,11055417
5,123230236,0,0,2,0,64414316,58815920
5,64414316,0,1,2,0,14782,64399534
5,180696860,0,1,2,0,123230236,57466624
5,180696860,0,1,3,0,14782,180682078
5,86215779,0,0,6,1,76833954,9381825
5,33670927,0,1,6,1,14782,33656145
5,176015527,0,1,7,0,131816147,44199380
5,86215779,0,0,10,1,76833954,9381825
5,33670927,0,1,10,1,14782,33656145
5,180696860,1,0,2,1,78872492,101824368
5,78872492,1,1,2,1,14782,78857710
5,180696860,1,0,3,1,14782,180682078
5,180696860,1,0,6,1,86215779,94481081
5,76833954,1,1,6,1,33670927,43163027
5,131816147,1,0,7,0,14782,131801365
5,180696860,1,0,7,0,176015527,4681333
5,180696860,1,0,10,1,86215779,94481081
5,76833954,1,1,10,1,33670927,43163027
5,11703716,1,0,11,0,14782,11688934
5,60979449,1,0,11,0,49653141,11326308
5,112954013,1,0,11,0,63447896,49506117
5,64414316,2,0,3,0,14782,64399534
5,180696860,2,0,3,0,123230236,57466624
5,180696860,2,1,3,1,78872492,101824368
5,33670927,2,0,6,1,14782,33656145
5,86215779,2,0,6,1,76833954,9381825
5,76833954,2,1,6,1,33670927,43163027
5,180696860,2,1,6,1,86215779,94481081
5,176015527,2,0,7,0,131816147,44199380
5,131816147,2,1,7,0,78872492,52943655
5,180696860,2,1,7,0,176015527,4681333
5,33670927,2,0,10,1,14782,33656145
5,86215779,2,0,10,1,76833954,9381825
5,76833954,2,1,10,1,33670927,43163027
5,180696860,2,1,10,1,86215779,94481081
5,112954013,2,1,11,0,78872492,34081521
5,33670927,3,0,6,1,14782,33656145
5,180696860,3,1,6,1,86215779,94481081
5,176015527,3,0,7,0,131816147,44199380
5,131816147,3,1,7,0,14782,131801365
5,180696860,3,1,7,0,176015527,4681333
5,33670927,3,0,10,1,14782,33656145
5,180696860,3,1,10,1,86215779,94481081
5,11703716,3,1,11,0,14782,11688934
5,60979449,3,1,11,0,49653141,11326308
5,112954013,3,1,11,0,63447896,49506117
5,207275,4,0,6,0,14782,192493
5,83672189,4,0,6,0,42638307,41033882
5,172323419,4,0,6,0,126862671,45460748
5,42638307,4,1,6,0,207275,42431032
5,126862671,4,1,6,0,83672189,43190482
5,180696860,4,1,6,0,172323419,8373441
5,160037691,5,0,7,1,14782,160022909
5,180696860,5,1,7,1,160037691,20659169
5,49653141,5,0,11,0,11703716,37949425
5,63447896,5,0,11,0,60979449,2468447
5,160037691,5,0,11,0,112954013,47083678
5,180696860,5,1,11,0,160037691,20659169
5,131816147,6,1,7,0,86215779,45600368
5,180696860,6,1,7,0,176015527,4681333
5,33670927,6,1,10,1,14782,33656145
5,76833954,6,1,10,1,33670927,43163027
5,86215779,6,1,10,1,76833954,9381825
5,180696860,6,1,10,1,86215779,94481081
5,112954013,6,1,11,0,86215779,26738234
5,131816147,7,0,10,1,86215779,45600368
5,180696860,7,0,10,1,176015527,4681333
5,11703716,7,0,11,0,14782,11688934
5,60979449,7,0,11,0,49653141,11326308
5,112954013,7,0,11,0,63447896,49506117
5,49653141,7,1,11,0,11703716,37949425
5,63447896,7,1,11,0,60979449,2468447
5,160037691,7,1,11,0,112954013,47083678
5,180696860,7,1,11,0,160037691,20659169
5,11923119,8,0,10,0,14782,11908337
5,54372028,8,0,10,0,49284892,5087136
5,180696860,8,0,10,0,157316748,23380112
5,49284892,8,1,10,0,11923119,37361773
5,157316748,8,1,10,0,54372028,102944720
5,165878654,9,0,11,1,163454996,2423658
5,180696860,9,0,11,1,175609529,5087331
5,163454996,9,1,11,1,14782,163440214
5,175609529,9,1,11,1,165878654,9730875
5,112954013,10,1,11,0,86215779,26738234
6,54771719,0,0,2,0,174798,54596921
6,87672673,0,0,2,0,65490512,22182161
6,65490512,0,1,2,0,54771719,10718793
6,170919470,0,1,2,0,87672673,83246797
6,71533470,0,0,3,0,174798,71358672
6,170919470,0,1,3,0,71533470,99386000
6,3125679,0,0,6,1,174798,2950881
6,31526979,0,0,6,1,7192230,24334749
6,169745647,0,1,6,1,146522328,23223319
6,3125679,0,0,10,1,174798,2950881
6,31526979,0,0,10,1,7192230,24334749
6,123953588,1,0,2,1,53173012,70780576
6,53173012,1,1,2,1,174798,52998214
6,170919470,1,1,2,1,123953588,46965882
6,117958504,1,0,3,1,174798,117783706
6,170919470,1,0,3,1,134754475,36164995
6,134754475,1,1,3,1,117958504,16795971
6,123953588,1,0,6,1,53173012,70780576
6,7192230,1,1,6,1,3125679,4066551
6,53173012,1,1,6,1,31526979,21646033
6,146522328,1,1,6,1,123953588,22568740
6,170919470,1,1,6,1,169745647,1173823
6,117958504,1,0,7,0,174798,117783706
6,170919470,1,0,7,0,134754475,36164995
6,134754475,1,1,7,0,117958504,16795971
6,123953588,1,0,10,1,53173012,70780576
6,7192230,1,1,10,1,3125679,4066551
6,53173012,1,1,10,1,31526979,21646033
6,132744734,1,1,10,1,123953588,8791146
6,73199323,1,0,11,0,174798,73024525
6,117958504,1,0,11,0,75905796,42052708
6,118742220,1,1,11,0,117958504,783716
6,54771719,2,0,3,0,174798,54596921
6,71533470,2,0,3,0,65490512,6042958
6,170919470,2,0,3,0,87672673,83246797
6,117958504,2,1,3,1,53173012,64785492
6,134754475,2,1,3,1,123953588,10800887
6,3125679,2,0,6,1,174798,2950881
6,31526979,2,0,6,1,7192230,24334749
6,169745647,2,0,6,1,146522328,23223319
6,7192230,2,1,6,1,3125679,4066551
6,53173012,2,1,6,1,31526979,21646033
6,123953588,2,1,6,1,53173012,70780576
6,146522328,2,1,6,1,123953588,22568740
6,170919470,2,1,6,1,169745647,1173823
6,117958504,2,1,7,0,53173012,64785492
6,134754475,2,1,7,0,123953588,10800887
6,3125679,2,0,10,1,174798,2950881
6,31526979,2,0,10,1,7192230,24334749
6,7192230,2,1,10,1,3125679,4066551
6,53173012,2,1,10,1,31526979,21646033
6,123953588,2,1,10,1,53173012,70780576
6,132744734,2,1,10,1,123953588,8791146
6,73199323,2,1,11,0,53173012,20026311
6,117958504,2,1,11,0,75905796,42052708
6,3125679,3,0,6,1,174798,2950881
6,31526979,3,0,6,1,7192230,24334749
6,169745647,3,0,6,1,146522328,23223319
6,117958504,3,1,6,1,53173012,64785492
6,134754475,3,1,6,1,123953588,10800887
6,117958504,3,1,7,0,174798,117783706
6,134754475,3,1,7,0,117958504,16795971
6,170919470,3,1,7,0,134754475,36164995
6,3125679,3,0,10,1,174798,2950881
6,31526979,3,0,10,1,7192230,24334749
6,117958504,3,1,10,1,53173012,64785492
6,132744734,3,1,10,1,123953588,8791146
6,73199323,3,1,11,0,174798,73024525
6,117958504,3,1,11,0,75905796,42052708
6,118742220,3,1,11,0,117958504,783716
6,146848176,4,0,6,0,174798,146673378
6,170919470,4,1,6,0,146848176,24071294
6,146848176,4,0,10,1,132744734,14103442
6,170919470,4,1,10,1,146848176,24071294
6,65190359,5,0,7,1,26279605,38910754
6,26279605,5,1,7,1,174798,26104807
6,170919470,5,1,7,1,65190359,105729111
6,75905796,5,1,11,0,73199323,2706473
6,170919470,5,1,11,0,118742220,52177250
6,117958504,6,1,7,0,53173012,64785492
6,134754475,6,1,7,0,123953588,10800887
6,146848176,6,0,10,1,132744734,14103442
6,170919470,6,0,10,1,146848176,24071294
6,3125679,6,1,10,1,174798,2950881
6,7192230,6,1,10,1,3125679,4066551
6,31526979,6,1,10,1,7192230,24334749
6,53173012,6,1,10,1,31526979,21646033
6,123953588,6,1,10,1,53173012,70780576
6,132744734,6,1,10,1,123953588,8791146
6,73199323,6,1,11,0,53173012,20026311
6,117958504,6,1,11,0,75905796,42052708
6,117958504,7,0,10,1,53173012,64785492
6,132744734,7,0,10,1,123953588,8791146
6,73199323,7,0,11,0,174798,73024525
6,117958504,7,0,11,0,75905796,42052708
6,118742220,7,0,11,0,117958504,783716
6,75905796,7,1,11,0,73199323,2706473
6,170919470,7,1,11,0,118742220,52177250
6,154004947,8,0,10,0,152134139,1870808
6,152134139,8,1,10,0,174798,151959341
6,170919470,8,1,10,0,154004947,16914523
6,166940443,9,0,11,1,23585329,143355114
6,23585329,9,1,11,1,174798,23410531
6,170919470,9,1,11,1,166940443,3979027
6,73199323,10,1,11,0,53173012,20026311
6,117958504,10,1,11,0,75905796,42052708
7,159124173,0,0,2,0,89598122,69526051
7,89598122,0,1,2,0,43748,89554374
7,102369835,0,0,3,0,46799155,55570680
7,46799155,0,1,3,0,43748,46755407
7,159124173,0,1,3,0,102369835,56754338
7,43036143,0,1,6,1,43748,42992395
7,159124173,0,1,7,0,143430391,15693782
7,159124173,0,1,11,0,143430391,15693782
7,57085653,1,0,2,1,43748,57041905
7,159124173,1,1,2,1,57085653,102038520
7,124516000,1,0,3,1,43748,124472252
7,159124173,1,0,3,1,135089463,24034710
7,135089463,1,1,3,1,124516000,10573463
7,57085653,1,0,6,1,43036143,14049510
7,159124173,1,1,6,1,57085653,102038520
7,124516000,1,0,7,0,43748,124472252
7,143430391,1,0,7,0,135089463,8340928
7,135089463,1,1,7,0,124516000,10573463
7,159124173,1,1,10,1,115298179,43825994
7,109038586,1,0,11,0,43748,108994838
7,124516000,1,0,11,0,123687728,828272
7,143430391,1,0,11,0,135089463,8340928
7,135089463,1,1,11,0,124516000,10573463
7,46799155,2,0,3,0,43748,46755407
7,102369835,2,0,3,0,89598122,12771713
7,57085653,2,1,3,1,43748,57041905
7,135089463,2,1,3,1,124516000,10573463
7,43036143,2,0,6,1,43748,42992395
7,57085653,2,1,6,1,43036143,14049510
7,159124173,2,1,6,1,57085653,102038520
7,57085653,2,1,7,0,43748,57041905
7,135089463,2,1,7,0,124516000,10573463
7,159124173,2,1,10,1,115298179,43825994
7,57085653,2,1,11,0,43748,57041905
7,135089463,2,1,11,0,124516000,10573463
7,43036143,3,0,6,1,43748,42992395
7,57085653,3,1,6,1,43036143,14049510
7,135089463,3,1,6,1,124516000,10573463
7,159124173,3,0,7,0,143430391,15693782
7,124516000,3,1,7,0,43748,124472252
7,135089463,3,1,7,0,124516000,10573463
7,143430391,3,1,7,0,135089463,8340928
7,135089463,3,1,10,1,124516000,10573463
7,159124173,3,0,11,0,143430391,15693782
7,109038586,3,1,11,0,43748,108994838
7,124516000,3,1,11,0,123687728,828272
7,135089463,3,1,11,0,124516000,10573463
7,143430391,3,1,11,0,135089463,8340928
7,37797762,4,0,6,0,43748,37754014
7,108002918,4,0,6,0,53590870,54412048
7,53590870,4,1,6,0,37797762,15793108
7,159124173,4,1,6,0,108002918,51121255
7,37797762,4,0,10,1,43748,37754014
7,108002918,4,0,10,1,53590870,54412048
7,53590870,4,1,10,1,37797762,15793108
7,115298179,4,1,10,1,108002918,7295261
7,159124173,5,0,7,1,120876161,38248012
7,120876161,5,1,7,1,43748,120832413
7,123687728,5,0,11,0,120876161,2811567
7,120876161,5,1,11,0,109038586,11837575
7,57085653,6,1,7,0,43036143,14049510
7,135089463,6,1,7,0,124516000,10573463
7,37797762,6,0,10,1,43748,37754014
7,53590870,6,0,10,1,37797762,15793108
7,108002918,6,0,10,1,53590870,54412048
7,115298179,6,0,10,1,108002918,7295261
7,159124173,6,1,10,1,115298179,43825994
7,57085653,6,1,11,0,43036143,14049510
7,135089463,6,1,11,0,124516000,10573463
7,135089463,7,0,10,1,124516000,10573463
7,109038586,7,0,11,0,43748,108994838
7,124516000,7,0,11,0,123687728,828272
7,135089463,7,0,11,0,124516000,10573463
7,143430391,7,0,11,0,135089463,8340928
7,159124173,7,0,11,0,143430391,15693782
7,120876161,7,1,11,0,109038586,11837575
7,123687728,7,1,11,0,120876161,2811567
7,8048055,8,0,10,0,43748,8004307
7,159124173,8,0,10,0,108437645,50686528
7,108437645,8,1,10,0,8048055,100389590
7,87745645,9,0,11,1,43748,87701897
7,159124173,9,0,11,1,106239315,52884858
7,106239315,9,1,11,1,87745645,18493670
7,135089463,10,1,11,0,124516000,10573463
8,146292681,0,1,2,0,170692,146121989
8,146292681,0,1,3,0,170692,146121989
8,146292681,0,1,6,1,38487307,107805374
8,133931121,0,1,7,0,170692,133760429
8,136979195,0,1,10,1,91589691,45389504
8,146292681,1,1,2,1,170692,146121989
8,146292681,1,0,3,1,68901355,77391326
8,68901355,1,1,3,1,170692,68730663
8,38487307,1,1,6,1,170692,38316615
8,146292681,1,0,7,0,133931121,12361560
8,146292681,2,0,3,0,170692,146121989
8,68901355,2,1,3,1,170692,68730663
8,146292681,2,0,6,1,38487307,107805374
8,38487307,2,1,6,1,170692,38316615
8,133931121,2,0,7,0,170692,133760429
8,136979195,2,0,10,1,91589691,45389504
8,146292681,3,0,6,1,38487307,107805374
8,38487307,3,1,6,1,170692,38316615
8,133931121,3,0,7,0,170692,133760429
8,146292681,3,1,7,0,133931121,12361560
8,136979195,3,0,10,1,91589691,45389504
8,146292681,4,0,6,0,170692,146121989
8,91589691,4,0,10,1,170692,91418999
8,146292681,4,0,10,1,136979195,9313486
8,45334175,5,0,7,1,170692,45163483
8,146292681,5,0,7,1,81345911,64946770
8,81345911,5,1,7,1,45334175,36011736
8,45334175,5,0,11,0,170692,45163483
8,146292681,5,0,11,0,81345911,64946770
8,81345911,5,1,11,0,45334175,36011736
8,133931121,6,1,7,0,38487307,95443814
8,91589691,6,0,10,1,170692,91418999
8,146292681,6,0,10,1,136979195,9313486
8,136979195,6,1,10,1,91589691,45389504
8,133931121,7,0,10,1,91589691,42341430
8,45334175,7,1,11,0,170692,45163483
8,81345911,7,1,11,0,45334175,36011736
8,146292681,7,1,11,0,81345911,64946770
8,42060960,8,0,10,0,23177634,18883326
8,23177634,8,1,10,0,170692,23006942
8,146292681,8,1,10,0,42060960,104231721
8,75054075,9,0,11,1,170692,74883383
8,146292681,9,0,11,1,99948713,46343968
8,99948713,9,1,11,1,75054075,24894638
9,69430690,0,0,2,0,126903,69303787
9,141068637,0,0,2,0,93923891,47144746
9,93923891,0,1,2,0,69430690,24493201
9,30424176,0,0,3,0,126903,30297273
9,141068637,0,0,3,0,48912778,92155859
9,48912778,0,1,3,0,30424176,18488602
9,141068637,0,0,6,1,93923891,47144746
9,93923891,0,1,6,1,81774585,12149306
9,30424176,0,0,7,0,19159733,11264443
9,103071039,0,0,7,0,48912778,54158261
9,48912778,0,1,7,0,30424176,18488602
9,136533433,0,0,10,1,93923891,42609542
9,93923891,0,1,10,1,81774585,12149306
9,141068637,1,0,2,1,126903,140941734
9,94099717,1,0,3,1,42369591,51730126
9,42369591,1,1,3,1,126903,42242688
9,141068637,1,1,3,1,94099717,46968920
9,81774585,1,0,6,1,126903,81647682
9,19159733,1,1,7,0,126903,19032830
9,141068637,1,1,7,0,103071039,37997598
9,19511516,1,0,10,1,126903,19384613
9,81774585,1,0,10,1,34001702,47772883
9,141068637,1,1,11,0,107174789,33893848
9,30424176,2,0,3,0,126903,30297273
9,69430690,2,0,3,0,48912778,20517912
9,141068637,2,0,3,0,93923891,47144746
9,94099717,2,1,3,1,42369591,51730126
9,93923891,2,0,6,1,81774585,12149306
9,141068637,2,0,6,1,93923891,47144746
9,81774585,2,1,6,1,126903,81647682
9,30424176,2,0,7,0,19159733,11264443
9,69430690,2,0,7,0,48912778,20517912
9,103071039,2,0,7,0,93923891,9147148
9,93923891,2,0,10,1,81774585,12149306
9,136533433,2,0,10,1,93923891,42609542
9,19511516,2,1,10,1,126903,19384613
9,81774585,2,1,10,1,34001702,47772883
9,141068637,3,0,6,1,93923891,47144746
9,81774585,3,1,6,1,42369591,39404994
9,30424176,3,0,7,0,19159733,11264443
9,48912778,3,0,7,0,30424176,18488602
9,103071039,3,0,7,0,48912778,54158261
9,19159733,3,1,7,0,126903,19032830
9,141068637,3,1,7,0,103071039,37997598
9,136533433,3,0,10,1,93923891,42609542
9,81774585,3,1,10,1,42369591,39404994
9,141068637,3,1,11,0,107174789,33893848
9,47589158,4,0,6,0,28287764,19301394
9,28287764,4,1,6,0,126903,28160861
9,141068637,4,1,6,0,47589158,93479479
9,34001702,4,0,10,1,28287764,5713938
9,28287764,4,1,10,1,19511516,8776248
9,141068637,4,1,10,1,136533433,4535204
9,141068637,5,0,7,1,115410987,25657650
9,115410987,5,1,7,1,126903,115284084
9,107174789,5,1,11,0,126903,107047886
9,103071039,6,1,7,0,93923891,9147148
9,28287764,6,0,10,1,19511516,8776248
9,34001702,6,0,10,1,28287764,5713938
9,141068637,6,0,10,1,136533433,4535204
9,19511516,6,1,10,1,126903,19384613
9,81774585,6,1,10,1,34001702,47772883
9,93923891,6,1,10,1,81774585,12149306
9,136533433,6,1,10,1,93923891,42609542
9,103071039,7,0,10,1,93923891,9147148
9,141068637,7,0,11,0,107174789,33893848
9,107174789,7,1,11,0,126903,107047886
9,141068637,8,0,10,0,71102442,69966195
9,71102442,8,1,10,0,126903,70975539
9,141068637,9,0,11,1,126903,140941734
10,52993371,0,0,2,0,18055562,34937809
10,135434303,0,0,2,0,117334717,18099586
10,18055562,0,1,2,0,131716,17923846
10,117334717,0,1,2,0,52993371,64341346
10,135434303,0,0,3,0,131716,135302587
10,52993371,0,0,6,1,18055562,34937809
10,135434303,0,0,6,1,117334717,18099586
10,18055562,0,1,6,1,937415,17118147
10,117334717,0,1,6,1,52993371,64341346
10,7893687,0,0,7,0,131716,7761971
10,129291140,0,0,7,0,84051704,45239436
10,48018843,0,0,10,1,18055562,29963281
10,135434303,0,0,10,1,132350768,3083535
10,18055562,0,1,10,1,5662931,12392631
10,129291140,0,0,11,0,84051704,45239436
10,105489400,1,0,2,1,19074319,86415081
10,19074319,1,1,2,1,131716,18942603
10,135434303,1,1,2,1,105489400,29944903
10,135434303,1,1,3,1,131716,135302587
10,937415,1,1,6,1,131716,805699
10,84051704,1,1,7,0,7893687,76158017
10,135434303,1,1,7,0,129291140,6143163
10,84051704,1,1,11,0,83599339,452365
10,135434303,1,1,11,0,129291140,6143163
10,52993371,2,0,3,0,18055562,34937809
10,135434303,2,0,3,0,117334717,18099586
10,19074319,2,1,3,1,131716,18942603
10,135434303,2,1,3,1,105489400,29944903
10,18055562,2,0,6,1,937415,17118147
10,52993371,2,0,6,1,18055562,34937809
10,117334717,2,0,6,1,52993371,64341346
10,135434303,2,0,6,1,117334717,18099586
10,937415,2,1,6,1,131716,805699
10,129291140,2,0,7,0,117334717,11956423
10,19074319,2,1,7,0,7893687,11180632
10,135434303,2,1,7,0,129291140,6143163
10,18055562,2,0,10,1,5662931,12392631
10,48018843,2,0,10,1,18055562,29963281
10,135434303,2,0,10,1,132350768,3083535
10,129291140,2,0,11,0,117334717,11956423
10,135434303,2,1,11,0,129291140,6143163
10,52993371,3,0,6,1,18055562,34937809
10,135434303,3,0,6,1,117334717,18099586
10,937415,3,1,6,1,131716,805699
10,7893687,3,0,7,0,131716,7761971
10,129291140,3,0,7,0,84051704,45239436
10,84051704,3,1,7,0,7893687,76158017
10,135434303,3,1,7,0,129291140,6143163
10,48018843,3,0,10,1,18055562,29963281
10,135434303,3,0,10,1,132350768,3083535
10,129291140,3,0,11,0,84051704,45239436
10,84051704,3,1,11,0,83599339,452365
10,135434303,3,1,11,0,129291140,6143163
10,135434303,4,0,6,0,130391674,5042629
10,130391674,4,1,6,0,131716,130259958
10,132350768,4,0,10,1,130391674,1959094
10,5662931,4,1,10,1,131716,5531215
10,130391674,4,1,10,1,48018843,82372831
10,28084203,5,0,7,1,131716,27952487
10,88287215,5,0,7,1,57597215,30690000
10,132997569,5,0,7,1,97495004,35502565
10,57597215,5,1,7,1,28084203,29513012
10,97495004,5,1,7,1,88287215,9207789
10,135434303,5,1,7,1,132997569,2436734
10,28084203,5,0,11,0,131716,27952487
10,83599339,5,0,11,0,57597215,26002124
10,57597215,5,1,11,0,28084203,29513012
10,129291140,6,1,7,0,117334717,11956423
10,5662931,6,0,10,1,131716,5531215
10,130391674,6,0,10,1,48018843,82372831
10,132350768,6,0,10,1,130391674,1959094
10,18055562,6,1,10,1,5662931,12392631
10,48018843,6,1,10,1,18055562,29963281
10,135434303,6,1,10,1,132350768,3083535
10,129291140,6,1,11,0,117334717,11956423
10,84051704,7,0,11,0,83599339,452365
10,129291140,7,0,11,0,84051704,45239436
10,135434303,7,0,11,0,129291140,6143163
10,28084203,7,1,11,0,131716,27952487
10,57597215,7,1,11,0,28084203,29513012
10,83599339,7,1,11,0,57597215,26002124
10,12798197,8,0,10,0,131716,12666481
10,128670990,8,0,10,0,114686274,13984716
10,114686274,8,1,10,0,12798197,101888077
10,135434303,8,1,10,0,128670990,6763313
10,12875836,9,0,11,1,9979848,2895988
10,9979848,9,1,11,1,131716,9848132
10,135434303,9,1,11,1,12875836,122558467
11,129468207,0,0,2,0,68869952,60598255
11,68869952,0,1,2,0,198986,68670966
11,134945120,0,1,2,0,129468207,5476913
11,40691551,0,0,3,0,198986,40492565
11,134945120,0,0,3,0,97995929,36949191
11,97995929,0,1,3,0,40691551,57304378
11,129468207,0,0,6,1,124117857,5350350
11,134945120,0,1,6,1,129468207,5476913
11,40691551,0,0,7,0,13509555,27181996
11,49545224,0,1,7,0,40691551,8853673
11,94863702,0,1,7,0,64059393,30804309
11,129468207,0,0,10,1,124117857,5350350
11,134945120,0,1,10,1,129468207,5476913
11,40691551,0,0,11,0,13509555,27181996
11,49545224,0,1,11,0,40691551,8853673
11,94863702,0,1,11,0,64059393,30804309
11,134945120,1,1,2,1,198986,134746134
11,131059747,1,0,3,1,198986,130860761
11,134945120,1,1,3,1,131059747,3885373
11,124117857,1,1,6,1,198986,123918871
11,13509555,1,0,7,0,198986,13310569
11,64059393,1,0,7,0,49545224,14514169
11,131059747,1,0,7,0,94863702,36196045
11,134945120,1,1,7,0,131059747,3885373
11,124117857,1,1,10,1,198986,123918871
11,13509555,1,0,11,0,198986,13310569
11,64059393,1,0,11,0,49545224,14514169
11,131059747,1,0,11,0,94863702,36196045
11,134945120,1,1,11,0,131059747,3885373
11,68869952,2,0,3,0,40691551,28178401
11,129468207,2,0,3,0,97995929,31472278
11,134945120,2,1,3,1,131059747,3885373
11,129468207,2,0,6,1,124117857,5350350
11,134945120,2,0,6,1,129468207,5476913
11,124117857,2,1,6,1,198986,123918871
11,49545224,2,0,7,0,40691551,8853673
11,68869952,2,0,7,0,64059393,4810559
11,134945120,2,1,7,0,131059747,3885373
11,129468207,2,0,10,1,124117857,5350350
11,134945120,2,0,10,1,129468207,5476913
11,124117857,2,1,10,1,198986,123918871
11,49545224,2,0,11,0,40691551,8853673
11,68869952,2,0,11,0,64059393,4810559
11,134945120,2,1,11,0,131059747,3885373
11,129468207,3,0,6,1,124117857,5350350
11,40691551,3,0,7,0,13509555,27181996
11,49545224,3,0,7,0,40691551,8853673
11,94863702,3,0,7,0,64059393,30804309
11,13509555,3,1,7,0,198986,13310569
11,64059393,3,1,7,0,49545224,14514169
11,131059747,3,1,7,0,94863702,36196045
11,134945120,3,1,7,0,131059747,3885373
11,129468207,3,0,10,1,124117857,5350350
11,40691551,3,0,11,0,13509555,27181996
11,49545224,3,0,11,0,40691551,8853673
11,94863702,3,0,11,0,64059393,30804309
11,13509555,3,1,11,0,198986,13310569
11,64059393,3,1,11,0,49545224,14514169
11,131059747,3,1,11,0,94863702,36196045
11,134945120,3,1,11,0,131059747,3885373
11,134945120,4,0,6,0,198986,134746134
11,134945120,5,0,7,1,198986,134746134
11,124117857,6,1,10,1,198986,123918871
11,129468207,6,1,10,1,124117857,5350350
11,134945120,6,1,10,1,129468207,5476913
11,13509555,7,0,11,0,198986,13310569
11,40691551,7,0,11,0,13509555,27181996
11,49545224,7,0,11,0,40691551,8853673
11,64059393,7,0,11,0,49545224,14514169
11,94863702,7,0,11,0,64059393,30804309
11,131059747,7,0,11,0,94863702,36196045
11,134945120,7,0,11,0,131059747,3885373
11,49016102,8,0,10,0,198986,48817116
11,134945120,8,0,10,0,82426908,52518212
11,82426908,8,1,10,0,49016102,33410806
11,134945120,9,0,11,1,97253613,37691507
11,97253613,9,1,11,1,198986,97054627
12,133801770,0,0,2,0,190980,133610790
12,133801770,0,1,3,0,190980,133610790
12,133801770,0,0,6,1,75922441,57879329
12,133801770,0,1,7,0,124016738,9785032
12,133801770,0,1,11,0,124016738,9785032
12,41270531,1,0,2,1,190980,41079551
12,133801770,1,0,2,1,132531015,1270755
12,132531015,1,1,2,1,41270531,91260484
12,12982871,1,0,3,1,190980,12791891
12,133801770,1,0,3,1,62504143,71297627
12,62504143,1,1,3,1,12982871,49521272
12,41270531,1,0,6,1,190980,41079551
12,75922441,1,1,6,1,41270531,34651910
12,12982871,1,0,7,0,190980,12791891
12,124016738,1,0,7,0,62504143,61512595
12,62504143,1,1,7,0,12982871,49521272
12,33447318,1,0,10,1,18897888,14549430
12,12982871,1,0,11,0,190980,12791891
12,124016738,1,0,11,0,102258853,21757885
12,25410016,1,1,11,0,12982871,12427145
12,12982871,2,1,3,1,190980,12791891
12,62504143,2,1,3,1,41270531,21233612
12,133801770,2,1,3,1,132531015,1270755
12,133801770,2,0,6,1,75922441,57879329
12,41270531,2,1,6,1,190980,41079551
12,75922441,2,1,6,1,41270531,34651910
12,12982871,2,1,7,0,190980,12791891
12,62504143,2,1,7,0,41270531,21233612
12,33447318,2,1,10,1,18897888,14549430
12,12982871,2,1,11,0,190980,12791891
12,12982871,3,1,6,1,190980,12791891
12,62504143,3,1,6,1,41270531,21233612
12,133801770,3,0,7,0,124016738,9785032
12,12982871,3,1,7,0,190980,12791891
12,62504143,3,1,7,0,12982871,49521272
12,124016738,3,1,7,0,62504143,61512595
12,133801770,3,0,11,0,124016738,9785032
12,12982871,3,1,11,0,190980,12791891
12,25410016,3,1,11,0,12982871,12427145
12,124016738,3,1,11,0,102258853,21757885
12,45410893,4,0,6,0,190980,45219913
12,133801770,4,1,6,0,45410893,88390877
12,18897888,4,0,10,1,190980,18706908
12,45410893,4,0,10,1,33447318,11963575
12,133801770,4,1,10,1,45410893,88390877
12,133801770,5,0,7,1,190980,133610790
12,102258853,5,0,11,0,25410016,76848837
12,12982871,6,1,7,0,190980,12791891
12,62504143,6,1,7,0,41270531,21233612
12,18897888,6,0,10,1,190980,18706908
12,45410893,6,0,10,1,33447318,11963575
12,133801770,6,0,10,1,45410893,88390877
12,33447318,6,1,10,1,18897888,14549430
12,12982871,6,1,11,0,190980,12791891
12,12982871,7,0,11,0,190980,12791891
12,25410016,7,0,11,0,12982871,12427145
12,124016738,7,0,11,0,102258853,21757885
12,133801770,7,0,11,0,124016738,9785032
12,102258853,7,1,11,0,25410016,76848837
12,56528873,8,0,10,0,5586160,50942713
12,64087203,8,0,10,0,59861111,4226092
12,97251375,8,0,10,0,86715007,10536368
12,5586160,8,1,10,0,190980,5395180
12,59861111,8,1,10,0,56528873,3332238
12,86715007,8,1,10,0,64087203,22627804
12,133801770,8,1,10,0,97251375,36550395
12,35356650,9,0,11,1,33585908,1770742
12,133801770,9,0,11,1,94918247,38883523
12,33585908,9,1,11,1,190980,33394928
12,94918247,9,1,11,1,35356650,59561597
13,25915061,0,0,2,0,19091021,6824040
13,115106996,0,0,2,0,95243876,19863120
13,95243876,0,1,2,0,25915061,69328815
13,35982630,0,0,3,0,19091021,16891609
13,115106996,0,0,3,0,44352674,70754322
13,44352674,0,1,3,0,35982630,8370044
13,56083954,0,1,6,1,45755243,10328711
13,35982630,0,0,7,0,19091021,16891609
13,77314878,0,0,7,0,44352674,32962204
13,44352674,0,1,7,0,35982630,8370044
13,77314878,0,0,11,0,76885449,429429
13,91409037,1,0,2,1,85393904,6015133
13,85393904,1,1,2,1,19091021,66302883
13,115106996,1,1,2,1,91409037,23697959
13,104723665,1,0,3,1,19091021,85632644
13,115106996,1,1,3,1,104723665,10383331
13,91409037,1,0,6,1,85393904,6015133
13,45755243,1,1,6,1,19091021,26664222
13,85393904,1,1,6,1,56083954,29309950
13,115106996,1,1,6,1,91409037,23697959
13,104723665,1,0,7,0,77314878,27408787
13,115106996,1,1,7,0,104723665,10383331
13,91409037,1,0,10,1,90983026,426011
13,42503402,1,1,10,1,19091021,23412381
13,115106996,1,1,10,1,91409037,23697959
13,104723665,1,0,11,0,77314878,27408787
13,115106996,1,1,11,0,104723665,10383331
13,25915061,2,0,3,0,19091021,6824040
13,44352674,2,0,3,0,35982630,8370044
13,115106996,2,0,3,0,95243876,19863120
13,91409037,2,1,3,1,85393904,6015133
13,115106996,2,1,3,1,104723665,10383331
13,56083954,2,0,6,1,45755243,10328711
13,45755243,2,1,6,1,19091021,26664222
13,85393904,2,1,6,1,56083954,29309950
13,91409037,2,1,6,1,85393904,6015133
13,115106996,2,1,6,1,91409037,23697959
13,25915061,2,0,7,0,19091021,6824040
13,44352674,2,0,7,0,35982630,8370044
13,91409037,2,1,7,0,85393904,6015133
13,115106996,2,1,7,0,104723665,10383331
13,42503402,2,1,10,1,19091021,23412381
13,91409037,2,1,10,1,90983026,426011
13,115106996,2,1,10,1,91409037,23697959
13,91409037,2,1,11,0,85393904,6015133
13,115106996,2,1,11,0,104723665,10383331
13,91409037,3,1,6,1,85393904,6015133
13,115106996,3,1,6,1,104723665,10383331
13,35982630,3,0,7,0,19091021,16891609
13,44352674,3,0,7,0,35982630,8370044
13,77314878,3,0,7,0,44352674,32962204
13,104723665,3,1,7,0,77314878,27408787
13,115106996,3,1,7,0,104723665,10383331
13,91409037,3,1,10,1,90983026,426011
13,115106996,3,1,10,1,104723665,10383331
13,77314878,3,0,11,0,76885449,429429
13,104723665,3,1,11,0,77314878,27408787
13,115106996,3,1,11,0,104723665,10383331
13,63819637,4,0,6,0,19091021,44728616
13,95804585,4,0,6,0,91922203,3882382
13,115106996,4,0,6,0,106802287,8304709
13,91922203,4,1,6,0,63819637,28102566
13,106802287,4,1,6,0,95804585,10997702
13,63819637,4,0,10,1,42503402,21316235
13,90983026,4,1,10,1,63819637,27163389
13,115106996,5,0,7,1,19091021,96015975
13,76885449,5,0,11,0,19091021,57794428
13,91409037,6,1,7,0,85393904,6015133
13,115106996,6,1,7,0,104723665,10383331
13,63819637,6,0,10,1,42503402,21316235
13,90983026,6,0,10,1,63819637,27163389
13,42503402,6,1,10,1,19091021,23412381
13,91409037,6,1,10,1,90983026,426011
13,115106996,6,1,10,1,91409037,23697959
13,91409037,6,1,11,0,85393904,6015133
13,115106996,6,1,11,0,104723665,10383331
13,91409037,7,0,10,1,90983026,426011
13,115106996,7,0,10,1,104723665,10383331
13,77314878,7,0,11,0,76885449,429429
13,104723665,7,0,11,0,77314878,27408787
13,115106996,7,0,11,0,104723665,10383331
13,76885449,7,1,11,0,19091021,57794428
13,115106996,8,0,10,0,19091021,96015975
13,46164117,9,0,11,1,26398340,19765777
13,105040924,9,0,11,1,78737155,26303769
13,115106996,9,0,11,1,109041321,6065675
13,26398340,9,1,11,1,19091021,7307319
13,78737155,9,1,11,1,46164117,32573038
13,109041321,9,1,11,1,105040924,4000397
13,91409037,10,1,11,0,90983026,426011
13,115106996,10,1,11,0,104723665,10383331
14,50849332,0,0,2,0,19108923,31740409
14,107282024,0,1,2,0,50849332,56432692
14,107282024,0,0,3,0,19108923,88173101
14,50849332,0,0,6,1,19108923,31740409
14,58956778,0,1,6,1,50849332,8107446
14,107282024,0,0,7,0,19108923,88173101
14,30758890,0,0,10,1,19108923,11649967
14,58956778,0,1,10,1,56260474,2696304
14,36922415,0,0,11,0,27850349,9072066
14,69496721,1,0,2,1,37894619,31602102
14,107282024,1,0,2,1,96730834,10551190
14,37894619,1,1,2,1,19108923,18785696
14,96730834,1,1,2,1,69496721,27234113
14,88064832,1,0,3,1,19922608,68142224
14,19922608,1,1,3,1,19108923,813685
14,107282024,1,1,3,1,88064832,19217192
14,69496721,1,0,6,1,58956778,10539943
14,107282024,1,0,6,1,96730834,10551190
14,96730834,1,1,6,1,69496721,27234113
14,69496721,1,0,10,1,58956778,10539943
14,107282024,1,0,10,1,96730834,10551190
14,96730834,1,1,10,1,69496721,27234113
14,50849332,2,0,3,0,19108923,31740409
14,19922608,2,1,3,1,19108923,813685
14,69496721,2,1,3,1,37894619,31602102
14,96730834,2,1,3,1,88064832,8666002
14,50849332,2,0,6,1,19108923,31740409
14,58956778,2,0,6,1,50849332,8107446
14,69496721,2,1,6,1,58956778,10539943
14,96730834,2,1,6,1,69496721,27234113
14,107282024,2,1,6,1,96730834,10551190
14,50849332,2,0,7,0,19108923,31740409
14,30758890,2,0,10,1,19108923,11649967
14,58956778,2,0,10,1,56260474,2696304
14,69496721,2,1,10,1,58956778,10539943
14,96730834,2,1,10,1,69496721,27234113
14,107282024,2,1,10,1,96730834,10551190
14,36922415,2,0,11,0,27850349,9072066
14,50849332,3,0,6,1,19108923,31740409
14,69496721,3,1,6,1,58956778,10539943
14,96730834,3,1,6,1,88064832,8666002
14,107282024,3,0,7,0,19108923,88173101
14,30758890,3,0,10,1,19108923,11649967
14,69496721,3,1,10,1,58956778,10539943
14,96730834,3,1,10,1,88064832,8666002
14,36922415,3,0,11,0,27850349,9072066
14,107282024,4,0,6,0,19108923,88173101
14,56260474,4,0,10,1,30758890,25501584
14,96158483,5,0,7,1,19108923,77049560
14,107282024,5,1,7,1,96158483,11123541
14,27850349,5,0,11,0,19108923,8741426
14,96158483,5,0,11,0,36922415,59236068
14,107282024,5,1,11,0,96158483,11123541
14,50849332,6,1,7,0,19108923,31740409
14,56260474,6,0,10,1,30758890,25501584
14,30758890,6,1,10,1,19108923,11649967
14,58956778,6,1,10,1,56260474,2696304
14,69496721,6,1,10,1,58956778,10539943
14,96730834,6,1,10,1,69496721,27234113
14,107282024,6,1,10,1,96730834,10551190
14,36922415,6,1,11,0,27850349,9072066
14,30758890,7,0,10,1,19108923,11649967
14,36922415,7,0,11,0,27850349,9072066
14,27850349,7,1,11,0,19108923,8741426
14,96158483,7,1,11,0,36922415,59236068
14,107282024,7,1,11,0,96158483,11123541
14,107282024,8,0,10,0,19108923,88173101
14,75462838,9,0,11,1,19108923,56353915
14,107282024,9,0,11,1,79432565,27849459
14,79432565,9,1,11,1,75462838,3969727
14,30758890,10,1,11,0,27850349,2908541
15,86021604,0,0,2,0,20011590,66010014
15,102398631,0,1,2,0,86021604,16377027
15,102398631,0,1,3,0,20011590,82387041
15,84463826,0,0,6,1,20011590,64452236
15,86021604,0,0,6,1,85850840,170764
15,102398631,0,1,6,1,86021604,16377027
15,102398631,0,1,7,0,65616037,36782594
15,44283743,0,0,10,1,20011590,24272153
15,102398631,1,0,2,1,44900367,57498264
15,44900367,1,1,2,1,20011590,24888777
15,102398631,1,0,3,1,20011590,82387041
15,85850840,1,0,6,1,84463826,1387014
15,65616037,1,0,7,0,20011590,45604447
15,102398631,2,0,3,0,86021604,16377027
15,102398631,2,1,3,1,44900367,57498264
15,84463826,2,0,6,1,20011590,64452236
15,86021604,2,0,6,1,85850840,170764
15,102398631,2,0,6,1,86021604,16377027
15,85850840,2,1,6,1,84463826,1387014
15,102398631,2,0,7,0,86021604,16377027
15,65616037,2,1,7,0,44900367,20715670
15,44283743,2,0,10,1,20011590,24272153
15,102398631,3,0,6,1,86021604,16377027
15,85850840,3,1,6,1,84463826,1387014
15,102398631,3,0,7,0,65616037,36782594
15,65616037,3,1,7,0,20011590,45604447
15,35979163,4,0,6,0,24149428,11829735
15,80240385,4,0,6,0,47022362,33218023
15,102398631,4,0,6,0,99271445,3127186
15,24149428,4,1,6,0,20011590,4137838
15,47022362,4,1,6,0,35979163,11043199
15,99271445,4,1,6,0,80240385,19031060
15,80240385,4,0,10,1,47022362,33218023
15,102398631,4,0,10,1,99271445,3127186
15,47022362,4,1,10,1,44283743,2738619
15,99271445,4,1,10,1,80240385,19031060
15,78886255,5,0,7,1,26072020,52814235
15,26072020,5,1,7,1,20011590,6060430
15,102398631,5,1,7,1,78886255,23512376
15,78886255,5,0,11,0,26072020,52814235
15,26072020,5,1,11,0,20011590,6060430
15,102398631,5,1,11,0,78886255,23512376
15,102398631,6,1,7,0,86021604,16377027
15,47022362,6,0,10,1,44283743,2738619
15,80240385,6,0,10,1,47022362,33218023
15,99271445,6,0,10,1,80240385,19031060
15,102398631,6,0,10,1,99271445,3127186
15,44283743,6,1,10,1,20011590,24272153
15,26072020,7,1,11,0,20011590,6060430
15,78886255,7,1,11,0,26072020,52814235
15,102398631,7,1,11,0,78886255,23512376
15,40041188,8,0,10,0,20011590,20029598
15,102398631,8,0,10,0,92648473,9750158
15,92648473,8,1,10,0,40041188,52607285
15,102398631,9,0,11,1,39407412,62991219
15,39407412,9,1,11,1,20011590,19395822
16,90153346,0,0,2,0,89659,90063687
16,90153346,0,1,3,0,89659,90063687
16,59164033,0,0,6,1,89659,59074374
16,90153346,0,0,6,1,76663875,13489471
16,51752683,0,1,7,0,89659,51663024
16,59164033,0,0,10,1,18570127,40593906
16,25826354,0,1,11,0,89659,25736695
16,90153346,1,0,2,1,45916365,44236981
16,45916365,1,1,2,1,89659,45826706
16,90153346,1,0,3,1,89659,90063687
16,76663875,1,0,6,1,59164033,17499842
16,90153346,1,0,7,0,51752683,38400663
16,75066063,1,0,10,1,59164033,15902030
16,90153346,2,1,3,1,45916365,44236981
16,59164033,2,0,6,1,89659,59074374
16,90153346,2,0,6,1,76663875,13489471
16,76663875,2,1,6,1,59164033,17499842
16,90153346,2,1,7,0,51752683,38400663
16,59164033,2,0,10,1,18570127,40593906
16,75066063,2,1,10,1,59164033,15902030
16,76663875,3,1,6,1,59164033,17499842
16,51752683,3,0,7,0,89659,51663024
16,90153346,3,1,7,0,51752683,38400663
16,75066063,3,1,10,1,59164033,15902030
16,25826354,3,0,11,0,89659,25736695
16,90153346,4,0,6,0,52731876,37421470
16,52731876,4,1,6,0,89659,52642217
16,90153346,4,0,10,1,75066063,15087283
16,18570127,4,1,10,1,89659,18480468
16,64874992,5,0,7,1,6640973,58234019
16,90153346,5,0,7,1,71670989,18482357
16,6640973,5,1,7,1,89659,6551314
16,71670989,5,1,7,1,64874992,6795997
16,64874992,5,0,11,0,25826354,39048638
16,90153346,5,0,11,0,71670989,18482357
16,71670989,5,1,11,0,64874992,6795997
16,76663875,6,1,7,0,59164033,17499842
16,18570127,6,0,10,1,89659,18480468
16,90153346,6,0,10,1,75066063,15087283
16,59164033,6,1,10,1,18570127,40593906
16,75066063,6,1,10,1,59164033,15902030
16,75066063,7,0,10,1,59164033,15902030
16,25826354,7,0,11,0,89659,25736695
16,64874992,7,1,11,0,25826354,39048638
16,71670989,7,1,11,0,64874992,6795997
16,90153346,7,1,11,0,71670989,18482357
16,90153346,8,1,10,0,89659,90063687
16,90153346,9,0,11,1,60700069,29453277
16,60700069,9,1,11,1,89659,60610410
17,29295196,0,0,2,0,28486735,808461
17,28486735,0,1,2,0,2220,28484515
17,81151539,0,1,2,0,29295196,51856343
17,81151539,0,1,3,0,2220,81149319
17,29295196,0,0,6,1,28486735,808461
17,28486735,0,1,6,1,2220,28484515
17,46333630,0,1,6,1,29295196,17038434
17,81151539,0,1,7,0,2220,81149319
17,29295196,0,0,10,1,28486735,808461
17,28486735,0,1,10,1,20372302,8114433
17,46333630,0,1,10,1,29295196,17038434
17,74678318,0,1,11,0,2121580,72556738
17,78808030,1,0,2,1,71526555,7281475
17,71526555,1,1,2,1,2220,71524335
17,81151539,1,1,2,1,78808030,2343509
17,37703222,1,0,3,1,2220,37701002
17,81151539,1,0,3,1,61185656,19965883
17,61185656,1,1,3,1,37703222,23482434
17,78808030,1,0,6,1,71526555,7281475
17,71526555,1,1,6,1,46333630,25192925
17,81151539,1,1,6,1,78808030,2343509
17,78808030,1,0,10,1,71526555,7281475
17,71526555,1,1,10,1,46333630,25192925
17,81151539,1,1,10,1,78808030,2343509
17,28486735,2,0,3,0,2220,28484515
17,81151539,2,0,3,0,29295196,51856343
17,61185656,2,1,3,1,37703222,23482434
17,78808030,2,1,3,1,71526555,7281475
17,28486735,2,0,6,1,2220,28484515
17,29295196,2,0,6,1,28486735,808461
17,46333630,2,0,6,1,29295196,17038434
17,71526555,2,1,6,1,46333630,25192925
17,78808030,2,1,6,1,71526555,7281475
17,81151539,2,1,6,1,78808030,2343509
17,28486735,2,0,7,0,2220,28484515
17,81151539,2,0,7,0,29295196,51856343
17,28486735,2,0,10,1,20372302,8114433
17,29295196,2,0,10,1,28486735,808461
17,46333630,2,0,10,1,29295196,17038434
17,71526555,2,1,10,1,46333630,25192925
17,78808030,2,1,10,1,71526555,7281475
17,81151539,2,1,10,1,78808030,2343509
17,28486735,2,0,11,0,2121580,26365155
17,74678318,2,0,11,0,29295196,45383122
17,28486735,3,0,6,1,2220,28484515
17,46333630,3,0,6,1,29295196,17038434
17,61185656,3,1,6,1,46333630,14852026
17,78808030,3,1,6,1,71526555,7281475
17,81151539,3,0,7,0,2220,81149319
17,28486735,3,0,10,1,20372302,8114433
17,46333630,3,0,10,1,29295196,17038434
17,61185656,3,1,10,1,46333630,14852026
17,78808030,3,1,10,1,71526555,7281475
17,74678318,3,0,11,0,2121580,72556738
17,31102619,4,0,6,0,2220,31100399
17,81151539,4,1,6,0,31102619,50048920
17,20372302,4,0,10,1,2220,20370082
17,81151539,5,0,7,1,24566028,56585511
17,24566028,5,1,7,1,2220,24563808
17,81151539,5,0,11,0,74678318,6473221
17,2121580,5,1,11,0,2220,2119360
17,28486735,6,1,7,0,2220,28484515
17,46333630,6,1,7,0,29295196,17038434
17,20372302,6,0,10,1,2220,20370082
17,28486735,6,1,10,1,20372302,8114433
17,29295196,6,1,10,1,28486735,808461
17,46333630,6,1,10,1,29295196,17038434
17,71526555,6,1,10,1,46333630,25192925
17,78808030,6,1,10,1,71526555,7281475
17,81151539,6,1,10,1,78808030,2343509
17,28486735,6,1,11,0,2121580,26365155
17,46333630,6,1,11,0,29295196,17038434
17,28486735,7,0,10,1,20372302,8114433
17,46333630,7,0,10,1,29295196,17038434
17,74678318,7,0,11,0,2121580,72556738
17,2121580,7,1,11,0,2220,2119360
17,81151539,7,1,11,0,74678318,6473221
17,15569108,8,0,10,0,2220,15566888
17,81151539,8,0,10,0,27996556,53154983
17,27996556,8,1,10,0,15569108,12427448
17,81151539,9,0,11,1,49628950,31522589
17,49628950,9,1,11,1,2220,49626730
17,28486735,10,1,11,0,20372302,8114433
17,46333630,10,1,11,0,29295196,17038434
18,78010620,0,0,2,0,22046223,55964397
18,22046223,0,1,2,0,134177,21912046
18,25618646,0,0,3,0,134177,25484469
18,78010620,0,1,3,0,25618646,52391974
18,78010620,0,0,6,1,40085457,37925163
18,25618646,0,0,7,0,134177,25484469
18,72155339,0,1,7,0,25618646,46536693
18,63767104,0,0,10,1,40085457,23681647
18,25618646,0,0,11,0,134177,25484469
18,72155339,0,1,11,0,25618646,46536693
18,78010620,1,0,2,1,134177,77876443
18,78010620,1,0,3,1,134177,77876443
18,40085457,1,0,6,1,134177,39951280
18,78010620,1,0,7,0,72155339,5855281
18,40085457,1,0,10,1,134177,39951280
18,78010620,1,0,11,0,72155339,5855281
18,25618646,2,0,3,0,22046223,3572423
18,78010620,2,1,3,1,134177,77876443
18,78010620,2,0,6,1,40085457,37925163
18,40085457,2,1,6,1,134177,39951280
18,25618646,2,0,7,0,22046223,3572423
18,78010620,2,1,7,0,72155339,5855281
18,63767104,2,0,10,1,40085457,23681647
18,40085457,2,1,10,1,134177,39951280
18,25618646,2,0,11,0,22046223,3572423
18,78010620,2,1,11,0,72155339,5855281
18,40085457,3,1,6,1,134177,39951280
18,25618646,3,0,7,0,134177,25484469
18,72155339,3,0,7,0,25618646,46536693
18,78010620,3,1,7,0,72155339,5855281
18,40085457,3,1,10,1,134177,39951280
18,25618646,3,0,11,0,134177,25484469
18,72155339,3,0,11,0,25618646,46536693
18,78010620,3,1,11,0,72155339,5855281
18,78010620,4,0,6,0,54909939,23100681
18,54909939,4,1,6,0,134177,54775762
18,78010620,4,0,10,1,63767104,14243516
18,2908347,5,0,7,1,134177,2774170
18,43407946,5,0,7,1,40200413,3207533
18,78010620,5,0,7,1,77476639,533981
18,40200413,5,1,7,1,2908347,37292066
18,77476639,5,1,7,1,43407946,34068693
18,78010620,6,0,10,1,63767104,14243516
18,40085457,6,1,10,1,134177,39951280
18,63767104,6,1,10,1,40085457,23681647
18,25618646,7,0,11,0,134177,25484469
18,72155339,7,0,11,0,25618646,46536693
18,78010620,7,0,11,0,72155339,5855281
18,78010620,8,1,10,0,134177,77876443
18,32585840,9,0,11,1,134177,32451663
18,78010620,9,1,11,1,32585840,45424780
19,59097933,0,1,2,0,247265,58850668
19,6734071,0,0,3,0,247265,6486806
19,59097933,0,0,3,0,27443976,31653957
19,27443976,0,1,3,0,6734071,20709905
19,20872107,0,1,6,1,247265,20624842
19,20872107,0,1,10,1,13300996,7571111
19,34042359,1,0,2,1,247265,33795094
19,59097933,1,1,2,1,34042359,25055574
19,59097933,1,0,3,1,247265,58850668
19,34042359,1,0,6,1,20872107,13170252
19,59097933,1,1,6,1,34042359,25055574
19,59097933,1,0,7,0,247265,58850668
19,34042359,1,0,10,1,20872107,13170252
19,59097933,1,1,10,1,34042359,25055574
19,12713563,1,0,11,0,247265,12466298
19,59097933,1,0,11,0,49583823,9514110
19,27443976,2,0,3,0,6734071,20709905
19,34042359,2,1,3,1,247265,33795094
19,20872107,2,0,6,1,247265,20624842
19,34042359,2,1,6,1,20872107,13170252
19,59097933,2,1,6,1,34042359,25055574
19,34042359,2,1,7,0,247265,33795094
19,20872107,2,0,10,1,13300996,7571111
19,34042359,2,1,10,1,20872107,13170252
19,59097933,2,1,10,1,34042359,25055574
19,12713563,2,1,11,0,247265,12466298
19,20872107,3,0,6,1,6734071,14138036
19,34042359,3,1,6,1,20872107,13170252
19,59097933,3,1,7,0,247265,58850668
19,20872107,3,0,10,1,13300996,7571111
19,34042359,3,1,10,1,20872107,13170252
19,12713563,3,1,11,0,247265,12466298
19,59097933,3,1,11,0,49583823,9514110
19,16180798,4,0,6,0,247265,15933533
19,59097933,4,0,6,0,37559553,21538380
19,37559553,4,1,6,0,16180798,21378755
19,13300996,4,0,10,1,247265,13053731
19,36765275,5,0,7,1,247265,36518010
19,59097933,5,0,7,1,50515791,8582142
19,50515791,5,1,7,1,36765275,13750516
19,36765275,5,0,11,0,12713563,24051712
19,49583823,5,1,11,0,36765275,12818548
19,34042359,6,1,7,0,20872107,13170252
19,13300996,6,0,10,1,247265,13053731
19,20872107,6,1,10,1,13300996,7571111
19,34042359,6,1,10,1,20872107,13170252
19,59097933,6,1,10,1,34042359,25055574
19,34042359,7,0,10,1,20872107,13170252
19,12713563,7,0,11,0,247265,12466298
19,59097933,7,0,11,0,49583823,9514110
19,36765275,7,1,11,0,12713563,24051712
19,49583823,7,1,11,0,36765275,12818548
19,10213937,8,0,10,0,247265,9966672
19,59097933,8,1,10,0,10213937,48883996
19,5814472,9,0,11,1,247265,5567207
19,59097933,9,0,11,1,23481258,35616675
19,23481258,9,1,11,1,5814472,17666786
20,62960292,0,0,2,0,61098,62899194
20,54426411,0,0,3,0,61098,54365313
20,62960292,0,0,3,0,54788110,8172182
20,54788110,0,1,3,0,54426411,361699
20,20238343,0,0,6,1,7090826,13147517
20,62960292,0,0,6,1,55642774,7317518
20,24224581,0,0,7,0,61098,24163483
20,19694586,0,0,10,1,7090826,12603760
20,24224581,0,0,11,0,23542016,682565
20,62960292,1,1,2,1,61098,62899194
20,43181579,1,0,3,1,30864269,12317310
20,30864269,1,1,3,1,61098,30803171
20,62960292,1,1,3,1,43181579,19778713
20,7090826,1,1,6,1,61098,7029728
20,55642774,1,1,6,1,20238343,35404431
20,43181579,1,0,7,0,30864269,12317310
20,30864269,1,1,7,0,24224581,6639688
20,62960292,1,1,7,0,43181579,19778713
20,7090826,1,1,10,1,61098,7029728
20,25365941,1,1,11,0,24224581,1141360
20,54426411,2,0,3,0,61098,54365313
20,62960292,2,0,3,0,54788110,8172182
20,30864269,2,1,3,1,61098,30803171
20,62960292,2,1,3,1,43181579,19778713
20,20238343,2,0,6,1,7090826,13147517
20,62960292,2,0,6,1,55642774,7317518
20,7090826,2,1,6,1,61098,7029728
20,55642774,2,1,6,1,20238343,35404431
20,24224581,2,0,7,0,61098,24163483
20,30864269,2,1,7,0,24224581,6639688
20,62960292,2,1,7,0,43181579,19778713
20,19694586,2,0,10,1,7090826,12603760
20,7090826,2,1,10,1,61098,7029728
20,24224581,2,0,11,0,23542016,682565
20,25365941,2,1,11,0,24224581,1141360
20,20238343,3,0,6,1,7090826,13147517
20,62960292,3,0,6,1,55642774,7317518
20,7090826,3,1,6,1,61098,7029728
20,30864269,3,1,6,1,20238343,10625926
20,55642774,3,1,6,1,43181579,12461195
20,24224581,3,0,7,0,61098,24163483
20,30864269,3,1,7,0,24224581,6639688
20,43181579,3,1,7,0,30864269,12317310
20,62960292,3,1,7,0,43181579,19778713
20,19694586,3,0,10,1,7090826,12603760
20,7090826,3,1,10,1,61098,7029728
20,24224581,3,0,11,0,23542016,682565
20,25365941,3,1,11,0,24224581,1141360
20,62960292,4,1,6,0,61098,62899194
20,62960292,4,1,10,1,19694586,43265706
20,62960292,5,0,7,1,61098,62899194
20,23542016,5,0,11,0,61098,23480918
20,62960292,5,0,11,0,25365941,37594351
20,20238343,6,1,7,0,7090826,13147517
20,30864269,6,1,7,0,24224581,6639688
20,55642774,6,1,7,0,43181579,12461195
20,62960292,6,0,10,1,19694586,43265706
20,7090826,6,1,10,1,61098,7029728
20,19694586,6,1,10,1,7090826,12603760
20,25365941,6,1,11,0,24224581,1141360
20,19694586,7,0,10,1,7090826,12603760
20,24224581,7,0,11,0,23542016,682565
20,25365941,7,0,11,0,24224581,1141360
20,23542016,7,1,11,0,61098,23480918
20,62960292,7,1,11,0,25365941,37594351
20,11398504,8,0,10,0,7218787,4179717
20,62960292,8,0,10,0,52036262,10924030
20,7218787,8,1,10,0,61098,7157689
20,52036262,8,1,10,0,11398504,40637758
20,4883637,9,0,11,1,61098,4822539
20,62960292,9,1,11,1,4883637,58076655
21,18298586,0,0,2,0,14359894,3938692
21,48099610,0,1,2,0,18298586,29801024
21,48099610,0,0,3,0,14359894,33739716
21,18298586,0,0,6,1,14359894,3938692
21,48099610,0,1,6,1,18298586,29801024
21,48099610,0,0,7,0,14359894,33739716
21,18298586,0,0,10,1,14359894,3938692
21,48099610,0,1,10,1,18298586,29801024
21,48099610,0,0,11,0,20345753,27753857
21,48099610,1,1,2,1,14359894,33739716
21,48099610,1,0,3,1,14359894,33739716
21,18298586,2,0,3,0,14359894,3938692
21,18298586,2,0,6,1,14359894,3938692
21,48099610,2,0,6,1,18298586,29801024
21,18298586,2,0,7,0,14359894,3938692
21,18298586,2,0,10,1,14359894,3938692
21,48099610,2,0,10,1,18298586,29801024
21,18298586,3,0,6,1,14359894,3938692
21,48099610,3,0,7,0,14359894,33739716
21,18298586,3,0,10,1,14359894,3938692
21,48099610,3,0,11,0,20345753,27753857
21,41368115,4,0,6,0,14359894,27008221
21,48099610,4,1,6,0,41368115,6731495
21,48099610,5,0,7,1,14359894,33739716
21,20345753,5,0,11,0,14359894,5985859
21,18298586,6,1,7,0,14359894,3938692
21,18298586,6,1,10,1,14359894,3938692
21,48099610,6,1,10,1,18298586,29801024
21,18298586,7,0,10,1,14359894,3938692
21,48099610,7,0,11,0,20345753,27753857
21,20345753,7,1,11,0,14359894,5985859
21,45822595,8,0,10,0,36986497,8836098
21,36986497,8,1,10,0,14359894,22626603
21,48099610,8,1,10,0,45822595,2277015
21,47380354,9,0,11,1,14359894,33020460
21,48099610,9,1,11,1,47380354,719256
22,51214796,0,1,2,0,16868036,34346760
22,51214796,0,0,3,0,16868036,34346760
22,51214796,0,0,7,0,16868036,34346760
22,51214796,0,0,11,0,16868036,34346760
22,51214796,1,1,2,1,16868036,34346760
22,49433433,1,0,3,1,16868036,32565397
22,51214796,1,1,3,1,49433433,1781363
22,51214796,1,1,6,1,16868036,34346760
22,51214796,1,1,10,1,16868036,34346760
22,51214796,2,1,3,1,49433433,1781363
22,51214796,2,1,6,1,16868036,34346760
22,51214796,2,1,10,1,16868036,34346760
22,51214796,3,1,6,1,49433433,1781363
22,51214796,3,0,7,0,16868036,34346760
22,51214796,3,1,10,1,49433433,1781363
22,51214796,3,0,11,0,16868036,34346760
22,51214796,4,0,6,0,17381770,33833026
22,17381770,4,1,6,0,16868036,513734
22,51214796,5,1,7,1,16868036,34346760
22,51214796,6,1,10,1,16868036,34346760
22,51214796,7,0,11,0,16868036,34346760
22,51214796,8,1,10,0,16868036,34346760
22,51214796,9,1,11,1,16868036,34346760
X,154854338,0,0,2,0,112325187,42529151
X,112325187,0,1,2,0,2700157,109625030
X,9019019,0,0,3,0,2700157,6318862
X,154854338,0,0,3,0,137875471,16978867
X,137875471,0,1,3,0,9019019,128856452
X,9019019,0,0,7,0,2700157,6318862
X,154854338,0,0,7,0,137875471,16978867
X,137875471,0,1,7,0,9019019,128856452
X,127801439,0,1,11,0,27029202,100772237
X,154854338,1,0,3,1,2700157,152154181
X,112325187,2,0,3,0,9019019,103306168
X,154854338,2,0,3,0,137875471,16978867
X,112325187,2,0,7,0,9019019,103306168
X,154854338,2,0,7,0,137875471,16978867
X,112325187,2,0,11,0,27029202,85295985
X,9019019,3,0,7,0,2700157,6318862
X,137875471,3,0,7,0,9019019,128856452
X,154854338,3,0,7,0,137875471,16978867
X,127801439,3,0,11,0,27029202,100772237
X,36121493,4,0,6,0,24248806,11872687
X,154854338,4,0,6,0,130524056,24330282
X,24248806,4,1,6,0,2700157,21548649
X,130524056,4,1,6,0,36121493,94402563
X,154854338,5,0,7,1,2700157,152154181
X,27029202,5,0,11,0,2700157,24329045
X,154854338,5,0,11,0,127801439,27052899
X,127801439,7,0,11,0,27029202,100772237
X,27029202,7,1,11,0,2700157,24329045
X,154854338,7,1,11,0,127801439,27052899
X,154854338,8,0,10,0,2700157,152154181
X,154854338,9,0,11,1,2700157,152154181
